0 0 0 0 0 0 0 0 0 0 0 0 0 0 0 0 
0 0 0 0 0 0 0 0 0 0 0 0 0 0 0 0 
0 0 0 0 0 0 0 0 0 0 0 0 0 0 0 0 
0 0 0 0 0 0 0 0 0 0 0 0 0 0 0 0 
0 0 0 0 0 0 0 0 0 0 0 0 0 0 0 0 
0 0 0 0 0 0 0 0 0 0 0 0 0 0 0 0 
0 0 0 0 0 0 0 0 0 0 0 0 0 0 0 0 
0 0 0 0 0 0 0 0 0 0 0 0 0 0 0 0 
0 0 0 0 0 0 1 0 1 1 0 0 0 0 0 0 
0 0 0 0 0 1 1 0 1 1 1 1 0 0 0 0 
0 0 0 1 2 4 3 0 3 4 2 1 0 0 0 0 
0 0 0 1 1 4 5 0 1 4 1 1 0 0 0 0 
0 0 0 1 2 4 3 3 3 4 2 1 0 0 0 0 
0 0 0 1 1 4 1 0 1 4 1 1 0 0 0 0 
0 0 0 1 2 4 3 0 3 4 2 1 0 0 0 0 
0 0 0 1 1 1 1 2 1 1 0 0 0 0 0 0 
0 0 0 0 0 1 1 0 1 1 0 0 0 0 0 0 
0 0 0 0 0 1 1 0 0 0 0 0 0 0 0 0 
0 0 0 0 0 0 0 0 0 0 0 0 0 0 0 0 
0 0 0 0 0 0 0 0 0 0 0 0 0 0 0 0 
0 0 0 0 0 0 0 0 0 0 0 0 0 0 0 0 
0 0 0 0 0 0 0 0 0 0 0 0 0 0 0 0 
0 0 0 0 0 0 0 0 0 0 0 0 0 0 0 0 
0 0 0 0 0 0 0 0 0 0 0 0 0 0 0 0 
